  1   2   0   0   0   0   0   0   0   0
  1   2   3   0   0  11  12  13   0   0
  0   2   3   4  10  11  12  13   0   0
 35  35   3   5   5   5   2  13  13   0
 35  35  34  34   6   6   2  14  17  16
 35  35  34  34  33   7   2  18  17  16
 35  35  34  34  33  32  20  20  20   0
  0  35  34  33  33   9  21  21  21   0
  0  35  34  33  32  23  23  23  23   0
  0  35  34  33  32  24  24  24  24  24
  0  35  34  33  32  31  25   6   7   0
 36  35  34  33  32  31  26   7   7   0
 36  35  34  33  32  31  30  29   7   0
  0  35  34  33  32  31   7   7  28   0
  0   0  35  34  33  32   0   0   0   0
